Drake: Hip-hop, trap, laid-back male vocals, ambient beats
Bruno Mars: Funk-pop blend, groovy rhythms, male vocals, danceable
Fleetwood Mac: Classic rock, mellow harmonies, emotional, 70s vibe
Ed Sheeran: Folk-pop, acoustic guitar loops, male vocals, mellow tone
Tim McGraw: Country Americana, steady rhythm, male vocals, heartfelt
Elton John: Piano-driven glam rock, theatrical male vocals, vibrant 70s flair
Dolly Parton: Country storytelling, twangy melodies, female vocals
Red Hot Chili Peppers: Funk rock, slap bass, male vocals, energetic Coldplay: Atmospheric alt-rock, ambient, male vocals, emotional piano
Taylor Swift: Pop, Alternative Folk, Emotional, female vocals
Elvis Presley: 50s Rock, Hero Theme, male vocals
Adele: Soul, Emotional, Torch-Lounge, female vocals
Ariana Grande: Pop, Dance Pop, Ethereal, female vocals
Billie Eilish: Pop, Dark, Minimal, female vocals
The Weeknd: RnB, Dark, Cinematic, male vocals
Beyoncé: RnB, Anthemic, Danceable, female vocals
Kendrick Lamar: HipHop, Lyrical, Storytelling, male vocals
Lady Gaga: Pop, Theatrical, Dance, female vocals
Jay-Z: HipHop, Aggressive, Storytelling, male vocals
Rihanna: RnB, Dance Pop, Festive, female vocals
Kanye West: HipHop, Progressive, Eclectic, male vocals
Justin Bieber: Pop, Danceable, Chillwave, male vocals
Katy Perry: Pop, Glitter, Festive, female vocals
Metallica: Thrash metal, aggressive riffs, pounding drums, male vocals
AC/DC: Hard rock, crunchy guitar riffs, raspy male vocals, driving rhythm
Madonna: Dance Pop, High-NRG, female vocals
David Bowie: 70s British Rock, Art, Eclectic, male vocals
Bob Dylan: Folk, Storytelling, Acoustic Guitar, male vocals
Post Malone: Rap, Ethereal, Ambient, male vocals
Maroon 5: Pop Rock, Danceable, male vocals
Shakira: Latin, Dance Pop, Festive, female vocals
Dua Lipa: Disco, Dance Pop, Groovy, female vocals
Michael Jackson: 80s Pop, Dance, Iconic, male vocals
Prince: Funk, Eclectic, Glam, male vocals
Miley Cyrus: Pop, Rock, Party, female vocals
Imagine Dragons: 2010s Rock, Anthemic, Emotion
Camila Cabello: Pop, Latin Jazz, Festive, female vocals
Harry Styles: Pop, Rock, Groovy, male vocals
Sam Smith: Soul, Emotional, Lounge, male vocals
Lizzo: Pop, Funk, Empowering, female vocals
Gorillaz: Alternative Rock, Electronic, Unusual
The Beatles: 60s British Pop, Classic, Rock
Queen: Rock, Operatic, Theatrical, Male Vocals
Led Zeppelin: Hard Rock, Blues Rock, Epic
Pink Floyd: 80s Rock, Progressive, Atmospheric
The Rolling Stones: Rock, Blues Rock, Classic
Bob Marley: Reggae, Peaceful, Soulful, male vocals
Frank Sinatra: 1940s big band, Lounge Singer, male vocals
Aretha Franklin: Soul, Gospel, Powerful, female vocals
Whitney Houston: Pop, RnB, Emotional, female vocals
Stevie Wonder: Soul, Funk, Joyful, male vocals
The Chainsmokers: EDM-pop, bright synths, party energy, pulsing beats
Nicki Minaj: Rap-pop, bold female vocals, playful attitude, rhythmic flow
Green Day: Punk rock, fast guitars, youthful rebellion, raw energy
Nirvana: 90s grunge, dark male vocals, distorted guitars, raw angst
Amy Winehouse: Soul-jazz, smoky female vocals, retro horns, intimate
Linkin Park: Nu-metal, emotional male vocals, rap-rock fusion, heavy riffs
Aerosmith: Classic hard rock, raspy male vocals, bluesy guitars, swagger
Bon Jovi: Arena rock, clean male vocals, big choruses, anthemic guitars
Billy Joel: Piano rock, male vocals, pop sensibility, melodic hooks, heartfelt
Phil Collins: 80s pop-rock, emotional male, cinematic drums, soft synths
Genesis: Progressive rock, layered textures, male vocals, synth-driven
The Eagles: Country rock, harmony vocals, smooth guitars, laid-back
Janis Joplin: Blues-rock, female vocals, raw emotion, soulful, classic 60s
Jimi Hendrix: Psychedelic rock, guitar virtuoso, wild solos, male vocals
The Who: Hard rock, theatrical male vocals, explosive guitars, dramatic
Iron Maiden: Heavy metal, epic storytelling, galloping riffs, theatrical
Judas Priest: Heavy metal, soaring male vocals, fast riffs, powerful sound
Slayer: Thrash metal, dark aggression, rapid-fire guitars, male vocals
Ozzy Osbourne: Heavy metal, dark theatrics, male vocals, dramatic riffs
Skrillex: Dubstep, Electronic, Intense, male vocals
Calvin Harris: EDM, Dance, Festive, male vocals
Arctic Monkeys: Indie Rock, Garage, Cool
Tame Impala: Psychedelic Rock, Dreamy, Mellifluous
The Strokes: Indie Rock, Cool, Raw
Vampire Weekend: Indie Rock, Eclectic, Upbeat
Kings of Leon: Rock, Emotional, Raw
The Killers: Rock, Synthpop, Anthemic, male vocals
System of a Down: Metal, Political, Eccentric
Radiohead: Alternative Rock, Experimental, Atmospheric
Foo Fighters: Rock, Alternative, Energetic
Muse: Rock, Progressive, Theatrical
Rage Against the Machine: Rap Metal, Political, Aggressive
Pearl Jam: Grunge, Rock, Emotional
Soundgarden: 90s Grunge, Heavy, Dark
Alice in Chains: Grunge, Dark, Melodic
Sigur Rós: Post-Rock, Ethereal, Atmospheric, Icelandic
Björk: Alternative, Experimental, Unusual, female vocals
Marshmello: EDM, Dance, Happy
Lana Del Rey: Pop, Sadcore, Cinematic, female vocals
Kacey Musgraves: Country, Pop, Mellifluous, female vocals
St. Vincent: Art Rock, Eclectic, Unusual, female vocals
Childish Gambino: HipHop, Funk, Thoughtful, male vocals
SZA: RnB, Neo Soul, Emotional, female vocals
Frank Ocean: RnB, Soulful, Introspective, male vocals
Tyler, The Creator: HipHop, Eclectic, Unusual, male vocals
Solange: RnB, Soul, Artistic, female vocals
Brockhampton: HipHop, Alternative, Collective
Mac DeMarco: Indie Pop, Slacker Rock, Chill, male vocals
Rufus Du Sol: Electronic, Dance, Atmospheric
Bon Iver: Indie Folk, Ethereal, Intimate, male vocals
Florence + The Machine: Indie Rock, Dramatic, Ethereal
Jack White: Rock, Blues, Raw, male vocals
Gary Clark Jr.: Blues Rock, Soulful, Gritty, male vocals
Leon Bridges: Soul, RnB, Retro, male vocals
Brittany Howard: Rock, Soul, Powerful, female vocals
Alabama Shakes: Rock, Blues Rock, Soulful
Glass Animals: Psychedelic Pop, Groovy, Eclectic
Portugal, The Man: Alternative Rock, Psychedelic, Catchy
FKA Twigs: RnB, Electronic, Avant-Garde, female vocals
The National: Indie Rock, Melancholy, Introspective
MGMT: Psychedelic Pop, Electronic, Playful
Empire of the Sun: Electronic, Pop, Theatrical
Grimes: Art Pop, Electronic, Experimental, female vocals
James Blake: Electronic, Soul, Minimalist, male vocals
The War on Drugs: Indie Rock, Heartland Rock, Melodic
Sufjan Stevens: Indie Folk, Baroque Pop, Intimate, male vocals
Nicolas Jaar: Electronic, Experimental, Atmospheric, male vocals
Flying Lotus: Electronic, Experimental HipHop, Fusion, male vocals
Thundercat: Funk, Jazz, Experimental, male vocals
Kamasi Washington: Jazz, Fusion, Epic, male vocals
Massive Attack: Trip Hop, Dark, Atmospheric
Portishead: Trip Hop, Dark, Cinematic
Aphex Twin: IDM, Electronic, Experimental, male vocals
Boards of Canada: IDM, Downtempo, Nostalgic
J Dilla: HipHop, Soulful, Experimental, male vocals
MF DOOM: HipHop, Abstract, Lyrical, male vocals
Kendrick Lamar: HipHop, Conscious, Lyrical, male vocals
Blink-182: emo pop rock, fast-paced, exciting, male vocals
Green Day: Punk Rock, Aggressive, Youthful
Phoebe Bridgers: Bedroom, grungegaze, catchy, psychedelic, acoustic tape recording, female vocals